0,0,0,0,0,0,0,0,0,0
0,0,0,0,1,1,1,1,0,0
0,0,2,1,4,0,0,1,0,0
0,2,2,4,4,1,1,1,1,0
0,0,2,3,1,1,4,1,0,0
0,0,0,0,0,0,1,1,0,0
0,0,0,0,0,0,0,0,0,0